摩卡|cha na tie|jia mo qia|mo qia|mo qia re tuo zhi nai na tie|nai mo qia|nong mo qia|nong yu ka fei mo qia|nong yu mo qia|tuo zhi nai mo qia
拿铁|na tie|na tie jiao tang ma qi duo|na tie mo qia|nong yu bing na tie|ping li qu na tie|quan zhi niu nai na tie|tuo zhi nai na tie|yi shi sheng dan na tie
馥芮白|flatwhite|fu rui bai|tuo zhi nai fu rui bai
卡布奇诺|qia bu qi nuo
焦糖玛奇朵|bei kao jiao tang ma qi duo|jiao tang ma qi duo|ma qi duo|si ji chun ma qi duo|tang ma qi duo|tuo zhi nai jiao tang ma qi duo
栗香玛奇朵|fu man li xiang ma qi duo|hao chang chun teng fu man li xiang ma qi duo
美式咖啡|mei shi|mei shi bing ka fei|quan bing mei shi|shao bing mei shi
巧克力|jing dian bing qiao ke li|jing dian re qiao ke li|qiao ke li|re qiao ke li|tuo zhi nai bing qiao ke li
茶|cha|nong du bing cha
红茶|bo jue hong cha|hong cha
绿茶|lv cha
乌龙茶|wu long cha
碧螺春|bi luo chun
冰摇茶|bing yao cha
黑加仑茶|bing yao hei jia lun cha|hei jia lun cha
红梅黑加仑茶|bing yao hong mei hei jia lun cha|yao hong mei hei jia lun cha
芒果木槿花茶|bing yao mang guo mu jin hua|mang guo mu jin hua
木槿花茶|mu jin hua
柠檬茶|bing yao ning meng cha|ning meng|ning meng cha
布丁奶茶|bu ding nai cha
红豆珍珠奶茶|hong dou zhen zhu nai cha
低咖啡因摩卡|di ka fei yin mo qia
低咖啡因拿铁|di ka fei yin na tie
豆奶摩卡|dou nai mo qia
豆奶拿铁|dou nai na tie
豆奶香草拿铁|dou nai xiang cha na tie
豆奶榛果拿铁|dou nai zhen guo na tie
海盐焦糖玛奇朵|hai yan jiao tang ma qi duo
焦糖拿铁|jiao tang feng wei na tie|jiao tang na tie|nong chun hei jiao tang na tie|tang jiao tang na tie|tang na tie
焦糖摩卡|jiao tang mo qia
红茶拿铁|hong cha na tie|ru yi tao hua hong cha na tie|tao hua hong cha na tie|ying shi hong cha na tie
焦糖咖啡星冰乐|jiao tang ka fei xing bing le
咖啡星冰乐|ka fei xing bing le|nong suo ka fei xing bing le
摩卡星冰乐|mo qia xing bing le
可可碎片星冰乐|ke ke sui pian xing bing le
芒果西番莲果茶星冰乐|mang guo xi fan lian guo cha xing bing le
蜂巢糖脆摩卡星冰乐|feng chao tang cui mo qia xing bing le
巧克力星冰乐|qiao ke li xing bing le
蓝莓优酪|lan mei you lao|you lao
蔓越莓白巧克力风味摩卡|man yue mei bai qiao ke li feng wei mo qia|man yue mei bai qiao ke li mo qia
巧克力榛果风味玛奇朵|qiao ke li zhen guo ma qi duo
曲奇拿铁|qu qi|qu qi na tie|xin yuan qu qi na tie
香草拿铁|hao xiang cha na tie|tang xiang cha na tie|xiang cha na tie
香草馥芮白|xiang cha fu rui bai
榛果馥芮白|zhen guo fu rui bai
香草玛奇朵|xiang ma qi duo
珍珠奶茶|zhen zhu nai cha
榛果糖浆|zhen guo tang jiang
香草糖浆|xiang cha tang jiang
榛果拿铁|tai fei zhen guo na tie|tuo zhi nai zhen guo na tie|zhen guo na tie
焦糖糖浆|jiao tang tang jiang
白巧克力|bai qiao ke li
白巧克力摩卡|bai qiao ke li mo qia
红豆巧克力|hong dou qiao ke li
美式加榛果糖浆|mei shi jia zhen guo tang jiang
美式香草星冰乐|mei shi xiang cha xing bing le|xiang cha xing bing le
抹茶拿铁|mo cha na tie|tang mo cha na tie|zheng chang mo cha na tie
抹茶星冰乐|mo cha xing bing le
摩卡碎片星冰乐|mo qia sui pian xing bing le
榛果拿铁星冰乐|tai fei zhen guo na tie xing bing le
